1111111111111
1P010000000C1
1000011111001
1E001100E0001
1000011111001
1000110000001
1111111111111