Q11111111111A
100100C0100CB
100001111100C
1P0011E000C01
11111111111bE