1111111111111
10010000000C1
1E00011111001
10001100E0001
1000011111001
1P00110000001
1111111111111