1111111111111
1P010000000C1
1000011111001
10001100E0001
1000011111P01
1P00110000001
1111111111111
