111111111111b
100100C0100Cb
100001111100b
1P0011E000C0b
11111111111ba