1111111111111
10010C0010001
100EE01111101
1PP0111000001
1111111111111