Q11111111111A
100100C0100CBd
100001111100C
1P0011E000C0D
11111111111bE