1111111111111111111111111111111111
1100000000000001110000000000000001
1010011100100000101001000000010101
1010010010101010111001000000101011
1P00000000000C00C0000000000E000001
1111111111111111111111111111111111