1111111111111111111111111111111111
110000000C000001110000000000000001
10100111001000001010010000C0010101
1010010010101010111001000000101011
1010011100100000101001000000010101
1010010010101000000001000000101011
1P00000000000100C0000000000E000001
1111111111111111111111111111111111