1111111111111111111111111111111111111111
11100000000000000000010000000000000000C1
1110000000000000000000000000000000000001
1000000110000000000001000000000000000001
1000000110000000000001000000000000000001
1E00000000000000001101000000000000000001
1111111111000000001101000000000000000001
1000000001000000001101000000000000000001
1001111101000000001101000000000000000001
1000000101000000001C01000000000000000001
11111101C1000000001111000000000000000001
1000000111000000000000000000000000000001
1011111100000000000000000000000000000001
1P0000000000000000001E000000000000000001
1111111111111111111111111111111111111111