1111111111111111111111111111111111111111
10000000000000000000000000000000000000E1
1011110111100000010000111101100100000001
1010000100100000010000100101010100000001
1010000100100000010000100101010100000001
1011110100100000010000100101010100000001
1000010100100000010000100101001100000001
1000010100100000010000100101001100000001
1011110111101111011110111101001100000001
1P000000000000000000000000000000000000C1
1111111111111111111111111111111111111111