1111111111111111111111111111111111111111
1100000001110000000011000000000000011001
101001000010C0010100000001110010C00011P1
10100100101000101011101001110010C0000101
10100111001010010101101001110010C0010101
10101010000000101011101001110010C0010101
1P00000000C00E000001101001110010C0000001
1111111111111111111111111111111111111111